14
12
1 8 8 8 8 8 8 8 8 8 8 8 8 9 
14 0 0 0 0 0 0 0 0 0 0 0 0 13 
13 0 0 0 0 0 0 0 0 0 0 0 0 13 
14 0 0 0 0 0 0 0 0 0 0 0 0 13 
14 0 0 0 0 0 0 0 0 0 0 0 0 13 
13 0 0 0 0 0 0 0 0 0 0 0 0 13 
13 0 0 0 0 0 0 0 0 0 0 0 0 13 
14 0 0 0 0 0 0 0 0 0 0 0 0 13 
14 0 0 0 0 0 0 0 0 0 0 0 0 13 
13 0 0 0 0 0 0 0 0 0 0 0 0 13 
14 0 0 0 0 0 0 0 0 0 0 0 0 13 
3 8 8 8 8 8 8 8 8 8 8 8 8 11 
8
0 2 2 2 3
0 2 2 5 2
0 2 2 8 5
0 2 2 10 2
0 2 2 4 5
0 2 2 8 1
0 2 2 2 7
0 6 8 6 8
