25
9
10 6 6 6 6 6 6 6 6 6 6 6 6 6 6 6 6 6 6 6 6 6 6 6 4 
11 0 0 0 0 0 0 0 0 0 0 0 0 0 0 0 0 0 0 0 0 0 0 0 11 
11 0 12 0 12 0 10 6 8 0 12 0 0 0 12 0 0 0 10 6 4 0 12 0 11 
11 0 11 0 11 0 11 0 0 0 11 0 0 0 11 0 0 0 11 0 11 0 11 0 11 
11 0 9 6 3 0 9 6 8 0 11 0 0 0 11 0 0 0 11 0 11 0 15 0 11 
11 0 11 0 11 0 11 0 0 0 11 0 0 0 11 0 0 0 11 0 11 0 0 0 11 
11 0 15 0 15 0 13 6 8 0 13 6 8 0 13 6 8 0 13 6 7 0 16 0 11 
11 0 0 0 0 0 0 0 0 0 0 0 0 0 0 0 0 0 0 0 0 0 0 0 11 
13 6 6 6 6 6 6 6 6 6 6 6 6 6 6 6 6 6 6 6 6 6 6 6 7 
0
