13
11
1 8 8 8 8 8 8 8 8 8 8 8 12 
14 0 0 0 0 0 0 0 0 0 0 0 0 
14 0 0 0 0 0 0 0 0 0 0 0 0 
14 0 0 0 0 0 0 0 0 0 0 0 0 
13 0 0 0 0 0 0 0 0 0 0 0 0 
13 0 0 0 0 0 0 0 0 1 5 5 9 
13 0 0 0 0 0 0 0 0 2 6 6 10 
2 8 8 12 0 0 0 0 0 4 8 8 10 
13 0 0 0 0 0 0 0 0 0 0 0 13 
13 0 20 24 24 28 0 20 24 24 28 0 13 
3 8 8 8 8 8 8 8 8 8 8 8 11 
3
0 2 2 1 5
1 1 1 2 9 5 9 1
1 1 1 7 9 10 9 1
