9
11
1 8 8 8 8 8 8 8 12 
13 0 0 0 0 0 0 0 0 
13 0 0 0 0 0 0 0 0 
13 0 0 0 0 0 0 0 0 
13 0 0 0 20 24 24 28 41 
13 0 0 0 0 20 24 24 28 
13 0 0 0 20 24 24 24 28 
13 0 0 0 0 0 0 0 13 
13 0 0 0 0 0 0 0 13 
1 5 5 9 0 0 0 0 13 
3 7 7 7 7 7 7 7 11 
4
0 2 2 6 8
1 4 1 1 4 4 4 1
1 4 1 1 5 5 5 1
1 5 1 1 6 4 6 1
