14
15
10 2 2 2 6 6 6 6 6 2 2 2 2 4 
9 5 5 7 0 0 0 0 0 13 5 5 5 6 
11 0 0 0 0 0 0 0 0 0 0 0 44 11 
11 0 0 0 0 0 44 0 0 0 0 0 43 11 
11 0 0 0 0 0 43 0 0 0 0 0 47 11 
11 0 0 30 22 24 43 30 22 22 28 14 2 3 
11 44 0 0 0 0 47 0 0 0 0 0 9 3 
11 43 0 0 0 0 0 0 0 0 0 0 9 3 
11 43 0 0 0 0 0 0 0 0 0 0 9 3 
11 43 0 0 14 6 6 4 0 0 0 0 9 3 
11 47 0 0 0 0 0 15 0 0 0 0 13 3 
11 0 0 0 0 0 0 0 0 0 0 0 0 11 
11 0 0 0 0 0 0 0 0 0 0 0 0 11 
11 0 0 10 4 30 22 22 22 22 24 0 0 107 
13 6 6 5 5 6 6 6 6 6 6 6 6 7 
6
1 2 1 9 5 3 5 2
1 1 1 6 3 6 6 1
1 1 1 1 6 1 10 1
1 2 1 9 13 5 13 1
1 1 1 12 2 12 4 1
0 2 2 5 10
