14
15
1 5 5 5 8 8 8 8 8 6 5 6 6 9 
2 7 7 11 0 0 0 0 0 3 7 7 7 6 
13 0 0 0 0 0 0 0 0 0 0 0 29 13 
14 0 0 0 0 0 29 0 0 0 0 0 30 14 
14 0 0 0 0 0 30 0 0 0 0 0 31 14 
13 0 0 20 24 24 30 24 24 24 28 4 5 10 
13 29 0 0 0 0 31 0 0 0 0 0 2 10 
13 30 0 0 0 0 0 0 0 0 0 0 2 10 
14 30 0 0 0 0 0 0 0 0 0 0 2 10 
13 30 0 0 4 8 8 9 0 0 0 0 2 10 
13 31 0 0 0 0 0 15 0 0 0 0 3 10 
14 0 0 0 0 0 0 0 0 0 0 0 0 14 
14 0 0 0 0 0 0 0 0 0 0 0 0 15 
13 0 0 1 9 20 24 24 24 24 28 0 0 0 
8 8 8 8 8 8 8 8 8 8 8 8 8 8 
6
1 1 1 12 2 12 4 1
0 9 7 5 10
1 2 1 9 5 3 5 2
1 1 1 6 3 6 6 1
1 1 1 1 6 1 10 1
1 2 1 9 13 5 13 1
