13
12
1 8 8 8 8 8 8 8 8 8 8 8 9 
14 0 0 0 0 0 0 0 0 0 0 0 13 
13 0 0 0 0 0 0 0 0 0 0 0 13 
14 0 0 0 0 0 0 0 0 0 0 0 14 
13 0 20 24 24 24 24 28 0 0 0 2 10 
13 0 0 20 24 0 24 28 0 0 0 2 10 
14 0 20 24 24 0 24 28 0 2 5 5 10 
13 0 0 20 24 0 24 28 0 2 6 6 10 
13 0 0 4 8 8 8 8 8 7 8 8 11 
14 0 0 0 0 0 0 0 0 0 0 0 39 
14 0 0 0 0 0 0 0 0 0 0 0 39 
3 8 8 8 8 8 8 8 8 8 8 8 11 
2
1 4 1 2 4 4 4 1
0 2 2 9 4
