13
9
10 6 6 2 2 2 2 6 6 6 6 6 4 
11 0 0 13 5 5 3 0 0 0 0 0 11 
11 0 0 0 0 0 9 4 0 0 0 0 11 
9 2 2 2 2 2 1 3 0 0 14 6 3 
9 5 5 5 1 5 1 1 2 8 0 0 11 
11 0 0 0 15 0 9 5 7 0 0 0 11 
11 0 0 0 0 14 7 0 0 0 0 0 11 
11 0 0 0 0 0 0 0 0 0 0 0 11 
13 6 6 6 6 6 6 6 6 6 6 6 7 
2
1 1 4 1 4 1 1 4
1 3 1 3 6 7 6 2
