9
11
10 6 6 6 6 6 6 6 4 
11 0 0 0 0 0 0 0 107 
11 0 0 0 0 0 0 0 107 
11 0 0 0 0 0 0 0 107 
11 0 0 0 20 18 18 20 15 
11 0 0 0 0 25 17 17 20 
11 0 0 0 20 21 21 21 23 
11 0 0 0 0 0 0 0 12 
11 0 0 0 0 0 0 0 11 
9 2 2 4 0 0 0 0 11 
13 5 5 5 6 6 6 6 7 
4
0 2 2 6 8
1 4 1 1 4 4 4 1
1 4 1 1 5 5 5 1
1 5 1 1 6 4 6 1
