10
8
10 6 6 6 6 6 6 6 6 4 
11 0 0 0 0 0 0 0 0 11 
11 0 0 0 0 0 0 0 0 11 
11 0 0 0 0 0 0 0 0 11 
11 0 0 0 0 0 0 0 0 11 
11 0 0 0 0 0 0 0 0 11 
11 0 0 0 0 0 0 0 0 11 
13 6 6 6 6 6 6 6 6 7 
1
1 3 2 4 2 5 4 5
