13
9
10 6 6 6 6 6 6 6 6 6 6 6 4 
11 0 0 0 0 0 0 0 0 0 0 0 11 
11 0 0 0 0 0 0 0 0 0 0 0 11 
11 0 0 0 0 0 0 0 0 0 0 0 11 
11 0 0 0 0 0 0 0 0 0 0 0 11 
11 0 0 0 0 0 0 0 0 0 0 0 11 
11 0 0 0 0 16 0 0 0 0 0 0 11 
11 0 0 0 0 0 0 0 0 0 0 0 11 
13 6 6 6 6 6 6 6 6 6 6 6 7 
2
1 1 1 1 1 5 1 1
0 2 2 10 6
