10
10
10 6 6 6 6 6 6 6 6 4 
15 0 0 0 0 0 0 0 0 11 
0 0 0 0 0 0 0 0 0 11 
12 0 0 0 0 0 0 0 0 11 
11 0 0 0 0 0 0 0 0 15 
11 0 0 0 0 0 0 0 0 0 
11 0 0 0 0 0 0 0 0 12 
11 0 0 0 0 0 0 0 0 11 
11 0 0 0 0 0 0 0 0 11 
13 6 6 6 6 6 6 6 6 7 
0
