25
9
10 6 6 6 6 6 6 6 6 6 6 6 6 6 6 6 6 6 6 6 6 6 6 6 4 
11 30 22 22 22 22 22 22 22 22 22 22 22 22 22 22 22 22 22 22 22 22 22 24 11 
11 44 10 6 8 44 12 46 34 40 12 44 10 6 4 44 14 2 8 44 12 44 12 44 11 
11 43 11 46 38 35 9 8 47 14 3 43 11 48 11 41 36 11 42 35 15 47 15 43 11 
11 43 9 6 8 43 11 44 16 44 11 43 9 6 7 41 35 11 41 33 36 12 42 35 11 
11 43 11 46 38 35 11 41 34 35 11 43 11 42 34 33 35 11 41 33 35 11 41 35 11 
11 47 13 6 8 47 15 45 37 39 15 47 15 45 37 37 39 15 45 37 39 15 45 39 11 
11 30 22 22 22 22 22 22 22 22 22 22 22 22 22 22 22 22 22 22 22 22 22 24 11 
13 6 6 6 6 6 6 6 6 6 6 6 6 6 6 6 6 6 6 6 6 6 6 6 7 
0
