9
6
1
1
1 1 1 1 1 1 1 1 1 
1 0 0 0 0 1 1 1 1 
1 0 0 0 0 1 1 1 1 
1 0 0 0 0 0 0 0 1 
1 0 0 0 0 0 0 0 1 
1 1 1 1 1 1 1 1 1 
3
0 2 2 3 1
1 1 1 1 4 7 4 1
1 1 1 1 1 1 1 1
