12
9
10 6 6 6 6 6 6 6 6 6 6 4 
11 0 0 0 0 0 0 0 0 0 0 11 
11 0 0 0 0 0 0 0 0 0 0 11 
11 0 0 0 0 0 0 0 0 0 0 11 
11 0 0 0 0 0 0 0 0 0 0 11 
11 0 0 0 0 0 0 0 0 0 0 11 
11 0 0 0 0 0 0 0 0 0 0 11 
11 0 0 0 0 0 0 0 0 0 0 11 
13 6 6 6 6 54 54 6 6 6 6 7 
5
0 1 4 4 3
1 2 2 9 6 6 6 1
1 1 1 7 1 7 3 1
2 2 7 1 2 1 0 1 2
3 3 1 3 7 
