12
10
10 6 6 6 6 6 6 6 6 6 6 4 
11 0 0 0 0 0 0 0 30 22 24 11 
11 0 0 0 0 0 0 0 10 2 2 3 
11 44 0 0 0 0 0 0 13 5 5 3 
11 43 0 0 0 0 0 0 140 0 0 11 
75 43 0 0 0 0 0 0 139 0 0 11 
75 43 0 0 0 0 0 0 139 0 0 11 
11 43 0 0 0 0 0 0 139 0 0 11 
11 47 0 0 0 0 0 0 143 0 0 11 
13 6 6 6 6 6 6 6 6 6 6 7 
9
1 1 2 1 6 1 7 1
1 1 2 1 4 1 3 1
1 2 1 9 1 8 1 1
2 9 8 1 2 2 0 1 2
2 10 8 1 1 0 0 2 1
2 10 7 1 1 1 0 1 2
0 2 2 2 7
3 2 1 7 1
3 3 1 5 8
