14
10
10 6 6 6 6 6 6 6 6 6 6 6 6 4 
11 0 0 0 0 0 0 0 0 0 0 0 0 11 
11 0 0 0 0 0 0 0 0 0 0 0 14 3 
11 0 0 0 0 0 0 0 0 0 0 0 0 11 
9 6 6 6 8 0 0 0 0 0 0 0 0 11 
11 0 0 0 0 0 0 0 0 0 10 4 0 11 
11 0 0 0 0 0 0 0 14 6 5 7 0 11 
11 0 0 0 0 0 0 0 0 0 0 0 0 11 
9 2 2 4 0 0 0 0 0 0 0 0 0 107 
13 5 5 5 6 6 6 6 6 6 6 6 6 7 
8
0 2 2 4 7
1 2 1 6 7 11 7 1
1 1 1 7 6 7 7 1
1 1 4 12 5 12 3 1
2 3 3 1 2 3 0 1 2
2 1 6 1 3 1 1 2 1
2 12 3 1 0 2 0 2 1
3 1 1 4 3

