10
10
10 6 6 6 6 6 6 6 6 4 
11 0 0 0 0 0 0 0 0 11 
11 0 0 0 0 0 0 0 0 11 
11 0 0 0 0 0 0 0 0 11 
11 0 0 0 0 0 0 0 0 11 
11 0 0 0 0 0 140 0 0 11 
11 0 0 0 0 0 139 0 0 11 
75 0 0 0 0 0 143 0 0 11 
75 0 0 0 0 0 0 0 0 11 
13 6 6 6 6 6 6 6 6 7 
1
0 2 2 4 6
