10
10
0 0 0 0 0 0 0 0 0 0 
0 0 0 0 0 0 0 0 0 0 
0 0 0 0 0 0 0 0 0 0 
0 0 0 0 0 0 0 0 0 0 
0 0 0 0 0 0 0 0 16 0 
0 0 0 0 0 0 0 0 0 12 
0 0 0 0 0 0 0 0 0 107 
0 0 0 0 0 0 0 0 0 107 
0 0 0 0 0 0 0 0 0 107 
14 6 6 6 6 6 6 6 6 7 
5
0 2 2 4 7
1 1 4 8 5 8 2 2
2 0 8 1 2 1 0 1 2
1 1 2 0 4 0 7 1.5
2 6 8 1 2 4 0 0 2
