25
9
14 6 6 6 6 6 6 6 6 6 6 6 6 6 6 6 6 6 6 6 6 6 6 6 8 
0 0 0 0 0 0 0 0 0 0 0 0 0 0 0 0 0 0 0 0 0 0 0 0 0 
0 10 6 6 8 0 12 0 12 0 10 8 0 10 8 0 10 8 0 10 8 0 10 8 0 
0 11 0 0 0 0 11 0 11 0 11 0 0 11 0 0 11 0 0 11 0 0 11 0 0 
0 13 6 6 4 0 11 0 11 0 11 0 0 11 0 0 9 8 0 13 4 0 13 4 0 
0 0 0 0 11 0 11 0 11 0 11 0 0 11 0 0 11 0 0 0 11 0 0 11 0 
0 14 6 6 7 0 13 6 7 0 13 8 0 13 8 0 13 8 0 14 7 0 14 7 0 
0 0 0 0 0 0 0 0 0 0 0 0 0 0 0 0 0 0 0 0 0 0 0 0 0 
14 6 6 6 6 6 6 6 6 6 6 6 6 6 6 6 6 6 6 6 6 6 6 6 8 
0
