9
8
10 6 6 6 6 6 6 6 4 
11 0 0 0 0 0 0 0 11 
11 0 0 0 0 0 0 0 11 
11 0 0 0 0 0 0 0 11 
11 0 0 0 0 0 0 0 11 
11 0 0 0 0 0 0 0 11 
75 0 0 0 0 0 0 0 11 
13 6 6 5 6 6 6 6 7 
2
0 2 2 3 5
1 2 1 6 4 6 6 1
