10
10
10 6 6 6 6 6 6 6 6 4 
11 0 0 0 0 0 0 0 0 11 
11 0 0 0 0 0 0 0 0 11 
11 0 0 0 0 0 0 0 0 11 
11 0 0 0 0 0 0 0 0 11 
11 0 0 0 0 0 0 0 0 11 
11 0 0 0 0 0 0 0 0 11 
11 0 0 0 0 0 0 0 0 11 
11 0 0 0 0 0 0 0 0 11 
13 6 6 6 6 6 6 6 6 7 
4
0 2 2 4 5
0 2 2 4 7
0 2 2 4 3
0 2 2 4 1
