16
9
10 6 6 6 6 6 6 6 6 6 6 6 6 6 6 4 
11 0 0 0 0 0 0 0 0 0 0 0 0 0 0 11 
11 0 0 0 0 0 0 0 0 0 0 0 0 0 0 11 
11 0 0 0 0 0 0 0 0 0 0 0 0 0 0 11 
11 0 0 0 0 0 0 0 0 0 0 0 0 0 0 11 
11 0 0 0 0 0 0 0 0 0 0 0 0 0 0 11 
9 2 2 2 4 0 0 0 0 0 0 0 1 1 0 11 
9 1 1 1 3 0 0 0 0 0 0 0 1 1 0 11 
13 5 5 5 5 6 6 6 6 6 6 5 5 6 6 7 
3
1 2 1 13 5 11 5 1
3 1 1 12 5
0 2 2 9 6

