10
10
0 0 0 0 0 0 0 0 0 0 
0 0 0 0 0 0 0 0 0 0 
0 0 0 0 0 0 0 0 0 0 
0 0 0 0 0 0 0 0 0 0 
0 0 0 0 0 0 0 0 0 0 
0 0 0 0 0 0 0 0 0 0 
14 6 6 8 0 0 14 6 6 8 
0 0 0 0 0 0 0 0 0 0 
0 0 0 0 0 0 0 0 0 0 
14 6 6 6 6 6 6 6 6 8 
1
0 2 2 1 4
