13
12
10 6 6 6 6 6 6 6 6 6 6 6 4 
11 0 0 0 0 0 0 0 0 0 0 0 11 
11 0 0 0 0 0 0 0 0 0 0 0 11 
11 0 0 0 0 0 0 0 0 0 0 0 11 
11 0 30 18 18 18 18 20 0 0 0 10 3 
11 0 0 25 17 17 17 19 0 0 0 9 3 
11 0 30 17 17 17 17 19 0 10 2 1 3 
11 0 0 29 21 21 21 23 0 9 1 1 3 
11 0 0 14 6 6 6 6 6 5 5 5 3 
11 0 0 0 0 0 0 0 0 0 0 0 107 
11 0 0 0 0 0 0 0 0 0 0 0 107 
13 6 6 6 6 6 6 6 6 6 6 6 7 
5
1 4 1 2 4 4 4 1
1 4 1 4 5 2 5 1
1 4 1 2 6 4 6 1
1 4 1 4 7 2 7 1
0 2 2 9 4
