10
7
10 6 6 6 6 6 6 6 6 4 
11 0 0 0 0 0 0 0 0 11 
11 0 0 0 0 0 0 0 0 11 
11 0 0 0 0 0 0 0 0 107 
11 0 0 0 0 0 0 0 0 107 
11 0 0 0 0 0 0 0 0 11 
13 6 6 6 6 6 6 6 6 7 
1
0 2 2 3 4
