10
10
0 0 0 0 0 0 0 0 0 12 
0 0 0 0 0 0 0 0 14 7 
0 0 0 0 0 0 0 0 0 0 
0 0 0 0 0 0 0 0 0 0 
0 0 0 0 0 0 0 0 0 0 
0 0 0 0 0 0 0 14 6 8 
10 6 8 0 0 0 16 0 0 0 
11 0 0 0 16 0 0 0 0 0 
11 0 0 0 0 0 0 0 10 4 
13 6 6 6 6 6 6 6 5 7 
2
0 2 2 3 6
1 1 1 7 8 1 8 1
