13
11
10 6 6 6 6 6 6 6 6 6 6 86 4 
11 0 0 0 0 0 0 0 0 0 0 0 11 
11 0 0 0 0 0 0 0 0 0 0 0 11 
11 0 0 0 0 0 0 0 0 0 0 0 11 
11 0 0 0 0 0 0 0 0 0 0 0 11 
11 0 0 0 0 0 0 0 0 10 2 2 3 
11 0 0 0 0 0 0 0 0 9 1 1 3 
9 6 6 8 0 0 0 0 0 13 5 5 3 
11 0 0 0 0 0 0 0 0 0 0 0 11 
11 0 30 22 22 24 0 30 22 22 24 0 11 
13 6 6 6 6 6 6 6 6 6 6 6 7 
3
0 2 2 1 5
1 1 1 2 9 5 9 1
1 1 1 7 9 10 9 1
